35
15
11111111111111111111111111111111111
12100000010000010000000000000000001
10101111111111011111111111111111101
10100000000000000000000000000000001
10111110111111111101111111111101111
10000000000000000100000000010000001
11111111111111111111111011110111101
10000000000000000100000000010010001
10111111111111111101111111111110111
10000000000000000100000001000000001
11111110111111110101011111111111101
10000000100000000101010000000000001
10111111111111111101011111111111111
10000000000000000001000000000000031
11111111111111111111111111111111111
